#########
#       #
#       #
# Op    #
#       #
#       #
#########
