#########
#       #
#       #
#.op    #
#       #
#       #
#########
